19 13
1 1 1 1 1 1 1 1 1 1 1 1 1 1 1 1 1 1 1
1 3 0 2 2 2 2 2 2 2 2 2 2 2 2 2 0 3 1
1 0 1 2 1 2 1 2 1 2 1 2 1 2 1 2 1 0 1
1 2 1 2 1 2 1 2 1 2 1 2 1 2 1 2 1 2 1
1 2 1 2 1 2 1 2 1 2 1 2 1 2 1 2 1 2 1
1 2 1 2 1 2 1 2 1 2 1 2 1 2 1 2 1 2 1
1 2 1 2 1 2 1 2 1 2 1 2 1 2 1 2 1 2 1
1 2 1 2 1 2 1 2 1 2 1 2 1 2 1 2 1 2 1
1 2 1 2 1 2 1 2 1 2 1 2 1 2 1 2 1 2 1
1 2 1 2 1 2 1 2 1 2 1 2 1 2 1 2 1 2 1
1 0 1 2 1 2 1 2 1 2 1 2 1 2 1 2 1 0 1
1 3 0 2 2 2 2 2 2 2 2 2 2 2 2 2 0 3 1
1 1 1 1 1 1 1 1 1 1 1 1 1 1 1 1 1 1 1
